Accuracy: 0.9564764138649987
Precision: [0.9620 0.8824 0.6667 0.8621 0.9841 0.5769 1.0000 0.9627 1.0000 0.9971 0.9767 1.0000 0.5000 0.6500 0.8750 1.0000 1.0000 0.5921 0.5000 0.6200 1.0000 0.8571 0.9944 0.7500 0.8889 1.0000 1.0000]
Recall: [0.9895 0.8955 0.8358 0.4902 0.9841 0.3846 1.0000 0.9667 1.0000 0.9850 0.9545 0.9867 0.5357 0.5652 0.8842 0.9545 0.8818 0.5625 0.3929 0.6739 0.9506 0.7636 0.9962 0.3000 0.7273 0.1538 0.7568]
F1 score: [0.9756 0.8889 0.7417 0.6250 0.9841 0.4615 1.0000 0.9647 1.0000 0.9910 0.9655 0.9933 0.5172 0.6047 0.8796 0.9767 0.9372 0.5769 0.4400 0.6458 0.9747 0.8077 0.9953 0.4286 0.8000 0.2667 0.8615]
Cohen Kappa score: 0.9389035152820946
Confusion matrix:
[[3574    8    1    4    0    1    0    2    0    5    1    0    0    0    5    0    0    1    4    0    0    2    2    1    1    0    0]
 [   7   60    0    0    0    0    0    0    0    0    0    0    0    0    0    0    0    0    0    0    0    0    0    0    0    0    0]
 [   5    0   56    0    0    0    0    5    0    0    0    0    0    0    0    0    0    0    0    0    0    1    0    0    0    0    0]
 [  26    0    0   25    0    0    0    0    0    0    0    0    0    0    0    0    0    0    0    0    0    0    0    0    0    0    0]
 [   0    0    0    0   62    0    0    0    0    0    0    0    0    0    0    0    0    0    0    0    0    1    0    0    0    0    0]
 [   2    0    0    0    0   15    0    0    0    0    0    0    3    1    3    0    0    9    1    5    0    0    0    0    0    0    0]
 [   0    0    0    0    0    0   30    0    0    0    0    0    0    0    0    0    0    0    0    0    0    0    0    0    0    0    0]
 [   2    0    4    0    0    0    0  232    0    0    0    0    0    0    0    0    0    0    0    0    0    2    0    0    0    0    0]
 [   0    0    0    0    0    0    0    0   48    0    0    0    0    0    0    0    0    0    0    0    0    0    0    0    0    0    0]
 [  26    0    0    0    0    0    0    0    0 1708    0    0    0    0    0    0    0    0    0    0    0    0    0    0    0    0    0]
 [   2    0    0    0    0    0    0    0    0    0   42    0    0    0    0    0    0    0    0    0    0    0    0    0    0    0    0]
 [   4    0    0    0    0    0    0    0    0    0    0  296    0    0    0    0    0    0    0    0    0    0    0    0    0    0    0]
 [   0    0    0    0    0    0    0    0    0    0    0    0   15    2    0    0    0    5    0    6    0    0    0    0    0    0    0]
 [   0    0    0    0    0    3    0    0    0    0    0    0    1   13    1    0    0    1    1    3    0    0    0    0    0    0    0]
 [   2    0    0    0    0    0    0    0    0    0    0    0    0    0   84    0    0    2    3    4    0    0    0    0    0    0    0]
 [   0    0    0    0    0    0    0    0    0    0    0    0    0    0    0   21    0    0    0    0    0    0    1    0    0    0    0]
 [  13    0    0    0    0    0    0    0    0    0    0    0    0    0    0    0   97    0    0    0    0    0    0    0    0    0    0]
 [   5    0    0    0    0    6    0    0    0    0    0    0    4    1    0    0    0   45    0   19    0    0    0    0    0    0    0]
 [  10    0    0    0    0    1    0    0    0    0    0    0    1    1    2    0    0    1   11    1    0    0    0    0    0    0    0]
 [   7    0    0    0    0    0    0    0    0    0    0    0    6    2    1    0    0   12    2   62    0    0    0    0    0    0    0]
 [  10    0    0    0    0    0    0    1    0    0    0    0    0    0    0    0    0    0    0    0  231    1    0    0    0    0    0]
 [   6    0    6    0    1    0    0    0    0    0    0    0    0    0    0    0    0    0    0    0    0   42    0    0    0    0    0]
 [   2    0    0    0    0    0    0    0    0    0    0    0    0    0    0    0    0    0    0    0    0    0  530    0    0    0    0]
 [   7    0    0    0    0    0    0    0    0    0    0    0    0    0    0    0    0    0    0    0    0    0    0    3    0    0    0]
 [   3    0    0    0    0    0    0    0    0    0    0    0    0    0    0    0    0    0    0    0    0    0    0    0    8    0    0]
 [   0    0   10    0    0    0    0    1    0    0    0    0    0    0    0    0    0    0    0    0    0    0    0    0    0    2    0]
 [   2    0    7    0    0    0    0    0    0    0    0    0    0    0    0    0    0    0    0    0    0    0    0    0    0    0   28]]
Labels: ['*not found', 'bordetella', 'campylobacter', 'chlamydia', 'clostridium', 'coronavirus', 'corynebacterium', 'escherichia', 'haemophilus', 'hepatitis c virus', 'herpesvirus', 'hiv', 'human bocavirus', 'human metapneumovirus', 'influzena', 'listeria', 'neisseria', 'parainfluenza or adenovirus', 'respiratory syncytial virus', 'rhinovirus or enterovirus', 'salmonella', 'shigella', 'streptococcus', 'treponema', 'trichomonas', 'vibrio', 'yersinia']
