Accuracy: 0.9549126922074538
Precision: [0.9602 0.8814 0.7093 0.9091 1.0000 0.4167 1.0000 0.9664 1.0000 0.9976 1.0000 0.9808 0.4737 0.6667 0.8889 1.0000 1.0000 0.7049 0.5000 0.6214 0.9676 0.9286 0.9938 0.7500 1.0000 0.9091 0.9808]
Recall: [0.9871 0.8525 0.8592 0.3390 0.9091 0.4167 0.9655 0.9705 1.0000 0.9817 0.9057 0.9685 0.7826 0.4167 0.8312 1.0000 0.8636 0.5658 0.3714 0.6882 0.9958 0.8387 0.9979 0.3750 1.0000 0.7143 0.8500]
F1 score: [0.9735 0.8667 0.7771 0.4938 0.9524 0.4167 0.9825 0.9684 1.0000 0.9896 0.9505 0.9746 0.5902 0.5128 0.8591 1.0000 0.9268 0.6277 0.4262 0.6531 0.9815 0.8814 0.9958 0.5000 1.0000 0.8000 0.9107]
Cohen Kappa score: 0.9357877489390859
Confusion matrix:
[[3669    7    5    2    0    2    0    3    0    4    0    5    0    0    2    0    0    1    4    1    4    3    3    1    0    0    1]
 [   9   52    0    0    0    0    0    0    0    0    0    0    0    0    0    0    0    0    0    0    0    0    0    0    0    0    0]
 [   4    0   61    0    0    0    0    5    0    0    0    0    0    0    0    0    0    0    0    0    0    0    0    0    0    1    0]
 [  38    0    0   20    0    0    0    0    0    0    0    1    0    0    0    0    0    0    0    0    0    0    0    0    0    0    0]
 [   4    0    0    0   40    0    0    0    0    0    0    0    0    0    0    0    0    0    0    0    0    0    0    0    0    0    0]
 [   2    0    0    0    0   15    0    0    0    0    0    0    2    1    0    0    0    5    3    8    0    0    0    0    0    0    0]
 [   1    0    0    0    0    0   28    0    0    0    0    0    0    0    0    0    0    0    0    0    0    0    0    0    0    0    0]
 [   1    0    3    0    0    0    0  230    0    0    0    0    0    0    0    0    0    0    0    0    3    0    0    0    0    0    0]
 [   0    0    0    0    0    0    0    0   34    0    0    0    0    0    0    0    0    0    0    0    0    0    0    0    0    0    0]
 [  31    0    0    0    0    0    0    0    0 1666    0    0    0    0    0    0    0    0    0    0    0    0    0    0    0    0    0]
 [   5    0    0    0    0    0    0    0    0    0   48    0    0    0    0    0    0    0    0    0    0    0    0    0    0    0    0]
 [  10    0    0    0    0    0    0    0    0    0    0  307    0    0    0    0    0    0    0    0    0    0    0    0    0    0    0]
 [   0    0    0    0    0    2    0    0    0    0    0    0   18    0    0    0    0    0    0    3    0    0    0    0    0    0    0]
 [   0    0    0    0    0    5    0    0    0    0    0    0    4   10    1    0    0    1    0    3    0    0    0    0    0    0    0]
 [   4    0    0    0    0    2    0    0    0    0    0    0    0    0   64    0    0    0    4    3    0    0    0    0    0    0    0]
 [   0    0    0    0    0    0    0    0    0    0    0    0    0    0    0   13    0    0    0    0    0    0    0    0    0    0    0]
 [  15    0    0    0    0    0    0    0    0    0    0    0    0    0    0    0   95    0    0    0    0    0    0    0    0    0    0]
 [   2    0    0    0    0    7    0    0    0    0    0    0    5    1    1    0    0   43    0   17    0    0    0    0    0    0    0]
 [   9    0    0    0    0    0    0    0    0    0    0    0    2    0    4    0    0    3   13    4    0    0    0    0    0    0    0]
 [   6    0    0    0    0    3    0    0    0    0    0    0    7    3    0    0    0    8    2   64    0    0    0    0    0    0    0]
 [   0    0    1    0    0    0    0    0    0    0    0    0    0    0    0    0    0    0    0    0  239    0    0    0    0    0    0]
 [   4    0    6    0    0    0    0    0    0    0    0    0    0    0    0    0    0    0    0    0    0   52    0    0    0    0    0]
 [   1    0    0    0    0    0    0    0    0    0    0    0    0    0    0    0    0    0    0    0    0    0  478    0    0    0    0]
 [   5    0    0    0    0    0    0    0    0    0    0    0    0    0    0    0    0    0    0    0    0    0    0    3    0    0    0]
 [   0    0    0    0    0    0    0    0    0    0    0    0    0    0    0    0    0    0    0    0    0    0    0    0    5    0    0]
 [   0    0    4    0    0    0    0    0    0    0    0    0    0    0    0    0    0    0    0    0    0    0    0    0    0   10    0]
 [   1    0    6    0    0    0    0    0    0    0    0    0    0    0    0    0    0    0    0    0    1    1    0    0    0    0   51]]
Labels: ['*not found', 'bordetella', 'campylobacter', 'chlamydia', 'clostridium', 'coronavirus', 'corynebacterium', 'escherichia', 'haemophilus', 'hepatitis c virus', 'herpesvirus', 'hiv', 'human bocavirus', 'human metapneumovirus', 'influzena', 'listeria', 'neisseria', 'parainfluenza or adenovirus', 'respiratory syncytial virus', 'rhinovirus or enterovirus', 'salmonella', 'shigella', 'streptococcus', 'treponema', 'trichomonas', 'vibrio', 'yersinia']
