Accuracy: 0.9563461037268699
Precision: [0.9649 0.8305 0.7073 0.9583 1.0000 0.4286 0.9487 0.9459 0.9818 0.9952 1.0000 0.9960 0.5882 0.5417 0.8133 1.0000 0.9747 0.7308 0.5500 0.6422 0.9731 0.9107 0.9982 0.7500 0.8889 1.0000 0.9677]
Recall: [0.9866 0.8596 0.7632 0.5476 1.0000 0.5000 0.9737 0.9533 1.0000 0.9777 0.9643 0.9688 0.5714 0.6190 0.8472 1.0000 0.8191 0.5507 0.3929 0.7692 0.9620 0.8793 0.9982 0.2308 1.0000 0.6500 0.8108]
F1 score: [0.9756 0.8448 0.7342 0.6970 1.0000 0.4615 0.9610 0.9496 0.9908 0.9864 0.9818 0.9822 0.5797 0.5778 0.8299 1.0000 0.8902 0.6281 0.4583 0.7000 0.9675 0.8947 0.9982 0.3529 0.9412 0.7879 0.8824]
Cohen Kappa score: 0.9385160140839724
Confusion matrix:
[[3605   10    3    1    0    6    2    2    0    8    0    1    0    0    5    0    2    0    1    1    1    3    1    1    1    0    0]
 [   8   49    0    0    0    0    0    0    0    0    0    0    0    0    0    0    0    0    0    0    0    0    0    0    0    0    0]
 [   4    0   58    0    0    0    0   11    0    0    0    0    0    0    0    0    0    0    0    0    2    1    0    0    0    0    0]
 [  19    0    0   23    0    0    0    0    0    0    0    0    0    0    0    0    0    0    0    0    0    0    0    0    0    0    0]
 [   0    0    0    0   55    0    0    0    0    0    0    0    0    0    0    0    0    0    0    0    0    0    0    0    0    0    0]
 [   1    0    0    0    0   18    0    0    0    0    0    0    0    3    3    0    0    3    0    8    0    0    0    0    0    0    0]
 [   0    0    1    0    0    0   37    0    0    0    0    0    0    0    0    0    0    0    0    0    0    0    0    0    0    0    0]
 [   3    0    5    0    0    0    0  245    0    0    0    0    0    0    0    0    0    0    0    0    4    0    0    0    0    0    0]
 [   0    0    0    0    0    0    0    0   54    0    0    0    0    0    0    0    0    0    0    0    0    0    0    0    0    0    0]
 [  38    0    0    0    0    0    0    0    0 1665    0    0    0    0    0    0    0    0    0    0    0    0    0    0    0    0    0]
 [   2    0    0    0    0    0    0    0    0    0   54    0    0    0    0    0    0    0    0    0    0    0    0    0    0    0    0]
 [   8    0    0    0    0    0    0    0    0    0    0  248    0    0    0    0    0    0    0    0    0    0    0    0    0    0    0]
 [   0    0    0    0    0    2    0    0    0    0    0    0   20    3    0    0    0    2    4    4    0    0    0    0    0    0    0]
 [   0    0    0    0    0    1    0    0    0    0    0    0    3   13    0    0    0    1    0    3    0    0    0    0    0    0    0]
 [   1    0    0    0    0    1    0    0    0    0    0    0    1    0   61    0    0    0    3    5    0    0    0    0    0    0    0]
 [   0    0    0    0    0    0    0    0    0    0    0    0    0    0    0   13    0    0    0    0    0    0    0    0    0    0    0]
 [  17    0    0    0    0    0    0    0    0    0    0    0    0    0    0    0   77    0    0    0    0    0    0    0    0    0    0]
 [   3    0    0    0    0    9    0    0    0    0    0    0    3    1    1    0    0   38    0   14    0    0    0    0    0    0    0]
 [   4    0    0    0    0    4    0    0    0    0    0    0    0    0    5    0    0    0   11    4    0    0    0    0    0    0    0]
 [   0    0    0    0    0    1    0    0    0    0    0    0    7    4    0    0    0    8    1   70    0    0    0    0    0    0    0]
 [   8    0    1    0    0    0    0    0    0    0    0    0    0    0    0    0    0    0    0    0  253    0    0    0    0    0    1]
 [   2    0    4    0    0    0    0    1    0    0    0    0    0    0    0    0    0    0    0    0    0   51    0    0    0    0    0]
 [   0    0    0    0    0    0    0    0    1    0    0    0    0    0    0    0    0    0    0    0    0    0  567    0    0    0    0]
 [  10    0    0    0    0    0    0    0    0    0    0    0    0    0    0    0    0    0    0    0    0    0    0    3    0    0    0]
 [   0    0    0    0    0    0    0    0    0    0    0    0    0    0    0    0    0    0    0    0    0    0    0    0    8    0    0]
 [   0    0    6    0    0    0    0    0    0    0    0    0    0    0    0    0    0    0    0    0    0    1    0    0    0   13    0]
 [   3    0    4    0    0    0    0    0    0    0    0    0    0    0    0    0    0    0    0    0    0    0    0    0    0    0   30]]
Labels: ['*not found', 'bordetella', 'campylobacter', 'chlamydia', 'clostridium', 'coronavirus', 'corynebacterium', 'escherichia', 'haemophilus', 'hepatitis c virus', 'herpesvirus', 'hiv', 'human bocavirus', 'human metapneumovirus', 'influzena', 'listeria', 'neisseria', 'parainfluenza or adenovirus', 'respiratory syncytial virus', 'rhinovirus or enterovirus', 'salmonella', 'shigella', 'streptococcus', 'treponema', 'trichomonas', 'vibrio', 'yersinia']
