Accuracy: 0.9530883502736512
Precision: [0.9587 0.8730 0.7439 0.8846 1.0000 0.4615 1.0000 0.9442 1.0000 0.9982 0.9403 0.9902 0.5600 0.5000 0.8734 1.0000 0.9733 0.6833 0.5217 0.5752 0.9568 0.9333 0.9946 0.3333 0.8889 0.8750 1.0000]
Recall: [0.9890 0.8594 0.7625 0.5227 0.9762 0.2553 0.9032 0.9834 1.0000 0.9770 0.9545 0.9681 0.4667 0.5652 0.8118 1.0000 0.7766 0.5942 0.4286 0.6915 0.9744 0.7778 1.0000 0.1250 1.0000 0.4667 0.7826]
F1 score: [0.9736 0.8661 0.7531 0.6571 0.9880 0.3288 0.9492 0.9634 1.0000 0.9875 0.9474 0.9790 0.5091 0.5306 0.8415 1.0000 0.8639 0.6357 0.4706 0.6280 0.9655 0.8485 0.9973 0.1818 0.9412 0.6087 0.8780]
Cohen Kappa score: 0.9339981822407892
Confusion matrix:
[[3594    8    2    3    0    1    0    4    0    2    3    2    0    0    0    0    2    0    1    0    5    1    3    2    0    1    0]
 [   9   55    0    0    0    0    0    0    0    0    0    0    0    0    0    0    0    0    0    0    0    0    0    0    0    0    0]
 [   8    0   61    0    0    0    0    8    0    0    0    0    0    0    0    0    0    0    0    0    3    0    0    0    0    0    0]
 [  20    0    1   23    0    0    0    0    0    0    0    0    0    0    0    0    0    0    0    0    0    0    0    0    0    0    0]
 [   1    0    0    0   41    0    0    0    0    0    0    0    0    0    0    0    0    0    0    0    0    0    0    0    0    0    0]
 [   4    0    0    0    0   12    0    0    0    0    0    0    2    3    2    0    0    5    1   18    0    0    0    0    0    0    0]
 [   3    0    0    0    0    0   28    0    0    0    0    0    0    0    0    0    0    0    0    0    0    0    0    0    0    0    0]
 [   2    0    0    0    0    0    0  237    0    0    0    0    0    0    0    0    0    0    0    0    1    1    0    0    0    0    0]
 [   0    0    0    0    0    0    0    0   44    0    0    0    0    0    0    0    0    0    0    0    0    0    0    0    0    0    0]
 [  38    0    0    0    0    0    0    0    0 1657    0    1    0    0    0    0    0    0    0    0    0    0    0    0    0    0    0]
 [   2    0    0    0    0    0    0    0    0    1   63    0    0    0    0    0    0    0    0    0    0    0    0    0    0    0    0]
 [  10    0    0    0    0    0    0    0    0    0    0  303    0    0    0    0    0    0    0    0    0    0    0    0    0    0    0]
 [   0    0    0    0    0    0    0    0    0    0    0    0   14    2    0    0    0    4    0   10    0    0    0    0    0    0    0]
 [   0    0    0    0    0    4    0    0    0    0    0    0    0   13    0    0    0    1    1    4    0    0    0    0    0    0    0]
 [   9    0    0    0    0    0    0    0    0    0    0    0    0    0   69    0    0    0    6    1    0    0    0    0    0    0    0]
 [   0    0    0    0    0    0    0    0    0    0    0    0    0    0    0   11    0    0    0    0    0    0    0    0    0    0    0]
 [  20    0    0    0    0    0    0    0    0    0    0    0    0    0    0    0   73    0    0    0    0    0    0    0    1    0    0]
 [   2    0    0    0    0    6    0    0    0    0    1    0    2    2    1    0    0   41    2   12    0    0    0    0    0    0    0]
 [   6    0    0    0    0    0    0    0    0    0    0    0    0    1    6    0    0    0   12    3    0    0    0    0    0    0    0]
 [   3    0    0    0    0    3    0    1    0    0    0    0    7    5    1    0    0    9    0   65    0    0    0    0    0    0    0]
 [   7    0    0    0    0    0    0    0    0    0    0    0    0    0    0    0    0    0    0    0  266    0    0    0    0    0    0]
 [   1    0    3    0    0    0    0    1    0    0    0    0    0    0    0    0    0    0    0    0    3   28    0    0    0    0    0]
 [   0    0    0    0    0    0    0    0    0    0    0    0    0    0    0    0    0    0    0    0    0    0  552    0    0    0    0]
 [   7    0    0    0    0    0    0    0    0    0    0    0    0    0    0    0    0    0    0    0    0    0    0    1    0    0    0]
 [   0    0    0    0    0    0    0    0    0    0    0    0    0    0    0    0    0    0    0    0    0    0    0    0    8    0    0]
 [   0    0    8    0    0    0    0    0    0    0    0    0    0    0    0    0    0    0    0    0    0    0    0    0    0    7    0]
 [   3    0    7    0    0    0    0    0    0    0    0    0    0    0    0    0    0    0    0    0    0    0    0    0    0    0   36]]
Labels: ['*not found', 'bordetella', 'campylobacter', 'chlamydia', 'clostridium', 'coronavirus', 'corynebacterium', 'escherichia', 'haemophilus', 'hepatitis c virus', 'herpesvirus', 'hiv', 'human bocavirus', 'human metapneumovirus', 'influzena', 'listeria', 'neisseria', 'parainfluenza or adenovirus', 'respiratory syncytial virus', 'rhinovirus or enterovirus', 'salmonella', 'shigella', 'streptococcus', 'treponema', 'trichomonas', 'vibrio', 'yersinia']
