Accuracy: 0.9611675788376336
Precision: [0.9668 0.8600 0.6512 1.0000 1.0000 0.5333 0.9583 0.9659 1.0000 0.9982 1.0000 0.9930 0.5217 0.6111 0.8219 1.0000 1.0000 0.5775 0.8000 0.7294 0.9580 0.9630 0.9923 0.0000 1.0000 1.0000 1.0000]
Recall: [0.9904 0.8776 0.8485 0.4167 0.9792 0.4706 1.0000 0.9444 0.9773 0.9826 0.9400 0.9725 0.6316 0.6471 0.8696 0.8889 0.8667 0.7069 0.4103 0.6458 0.9956 0.8814 1.0000 0.0000 1.0000 0.3077 0.8462]
F1 score: [0.9785 0.8687 0.7368 0.5882 0.9895 0.5000 0.9787 0.9551 0.9885 0.9903 0.9691 0.9826 0.5714 0.6286 0.8451 0.9412 0.9286 0.6357 0.5424 0.6851 0.9764 0.9204 0.9961 0.0000 1.0000 0.4706 0.9167]
Cohen Kappa score: 0.9444116599750131
Confusion matrix:
[[3701    7    3    0    0    0    1    2    0    3    0    2    0    0    4    0    0    3    0    0    5    2    3    1    0    0    0]
 [   5   43    1    0    0    0    0    0    0    0    0    0    0    0    0    0    0    0    0    0    0    0    0    0    0    0    0]
 [   4    0   56    0    0    0    0    5    0    0    0    0    0    0    0    0    0    0    0    0    1    0    0    0    0    0    0]
 [  28    0    0   20    0    0    0    0    0    0    0    0    0    0    0    0    0    0    0    0    0    0    0    0    0    0    0]
 [   1    0    0    0   47    0    0    0    0    0    0    0    0    0    0    0    0    0    0    0    0    0    0    0    0    0    0]
 [   3    0    0    0    0   16    0    0    0    0    0    0    1    5    1    0    0    1    0    7    0    0    0    0    0    0    0]
 [   0    0    0    0    0    0   23    0    0    0    0    0    0    0    0    0    0    0    0    0    0    0    0    0    0    0    0]
 [   2    0    9    0    0    0    0  255    0    0    0    0    0    0    0    0    0    0    0    0    4    0    0    0    0    0    0]
 [   0    0    0    0    0    0    0    0   43    0    0    0    0    0    0    0    0    0    0    0    0    0    1    0    0    0    0]
 [  30    0    0    0    0    0    0    0    0 1692    0    0    0    0    0    0    0    0    0    0    0    0    0    0    0    0    0]
 [   3    0    0    0    0    0    0    0    0    0   47    0    0    0    0    0    0    0    0    0    0    0    0    0    0    0    0]
 [   8    0    0    0    0    0    0    0    0    0    0  283    0    0    0    0    0    0    0    0    0    0    0    0    0    0    0]
 [   0    0    0    0    0    0    0    0    0    0    0    0   12    0    0    0    0    2    0    5    0    0    0    0    0    0    0]
 [   0    0    0    0    0    0    0    0    0    0    0    0    1   11    0    0    0    2    0    3    0    0    0    0    0    0    0]
 [   2    0    0    0    0    1    0    0    0    0    0    0    0    2   60    0    0    0    3    1    0    0    0    0    0    0    0]
 [   1    0    0    0    0    0    0    0    0    0    0    0    0    0    0    8    0    0    0    0    0    0    0    0    0    0    0]
 [  14    0    0    0    0    0    0    0    0    0    0    0    0    0    0    0   91    0    0    0    0    0    0    0    0    0    0]
 [   5    0    0    0    0    4    0    0    0    0    0    0    2    0    1    0    0   41    0    5    0    0    0    0    0    0    0]
 [   9    0    0    0    0    2    0    0    0    0    0    0    1    0    7    0    0    2   16    2    0    0    0    0    0    0    0]
 [   0    0    0    0    0    7    0    0    0    0    0    0    6    0    0    0    0   20    1   62    0    0    0    0    0    0    0]
 [   1    0    0    0    0    0    0    0    0    0    0    0    0    0    0    0    0    0    0    0  228    0    0    0    0    0    0]
 [   1    0    4    0    0    0    0    2    0    0    0    0    0    0    0    0    0    0    0    0    0   52    0    0    0    0    0]
 [   0    0    0    0    0    0    0    0    0    0    0    0    0    0    0    0    0    0    0    0    0    0  515    0    0    0    0]
 [   6    0    0    0    0    0    0    0    0    0    0    0    0    0    0    0    0    0    0    0    0    0    0    0    0    0    0]
 [   0    0    0    0    0    0    0    0    0    0    0    0    0    0    0    0    0    0    0    0    0    0    0    0    6    0    0]
 [   0    0    9    0    0    0    0    0    0    0    0    0    0    0    0    0    0    0    0    0    0    0    0    0    0    4    0]
 [   4    0    4    0    0    0    0    0    0    0    0    0    0    0    0    0    0    0    0    0    0    0    0    0    0    0   44]]
Labels: ['*not found', 'bordetella', 'campylobacter', 'chlamydia', 'clostridium', 'coronavirus', 'corynebacterium', 'escherichia', 'haemophilus', 'hepatitis c virus', 'herpesvirus', 'hiv', 'human bocavirus', 'human metapneumovirus', 'influzena', 'listeria', 'neisseria', 'parainfluenza or adenovirus', 'respiratory syncytial virus', 'rhinovirus or enterovirus', 'salmonella', 'shigella', 'streptococcus', 'treponema', 'trichomonas', 'vibrio', 'yersinia']
